//MAP CONVERTED BY dmm2tgm.py THIS HEADER COMMENT PREVENTS RECONVERSION, DO NOT REMOVE
"al" = (
/obj/effect/decal/cleanable/blood,
/turf/open/shuttle/dropship/light_grey_single_wide_up_to_down,
/area/template_noop)
"aD" = (
/obj/effect/decal{
	icon = 'icons/mob/xenos/effects.dmi';
	icon_state = "acid_weak";
	name = "weak acid";
	layer = 12
	},
/turf/closed/shuttle/dropship3/transparent{
	icon_state = "27"
	},
/area/template_noop)
"bu" = (
/turf/closed/shuttle/dropship3{
	icon_state = "51"
	},
/area/template_noop)
"bw" = (
/obj/structure/platform/metal/almayer/north,
/obj/structure/machinery/light/double{
	dir = 4;
	pixel_y = -5
	},
/turf/open/shuttle/dropship/light_grey_single_wide_up_to_down,
/area/template_noop)
"bT" = (
/obj/effect/decal/hybrisa/dirt,
/obj/structure/surface/rack{
	color = "#848484"
	},
/obj/item/weapon/gun/rifle/l42a,
/turf/open/shuttle/dropship/medium_grey_single_wide_up_to_down,
/area/template_noop)
"cU" = (
/obj/structure/shuttle/part/dropship3/transparent/engine_right_cap,
/turf/open/floor/plating/platingdmg3,
/area/template_noop)
"dj" = (
/turf/open/shuttle/dropship/medium_grey_single_wide_up_to_down,
/area/template_noop)
"dz" = (
/turf/open/shuttle/dropship/light_grey_single_wide_left_to_right,
/area/template_noop)
"dH" = (
/obj/structure/prop/invuln/fire,
/turf/closed/shuttle/dropship3/transparent{
	icon_state = "38"
	},
/area/template_noop)
"dZ" = (
/obj/structure/bed/chair/vehicle{
	pixel_x = -8
	},
/obj/structure/bed/chair/vehicle{
	pixel_x = 8
	},
/obj/effect/landmark/corpsespawner/hybrisa/civilian,
/turf/open/shuttle/dropship/medium_grey_single_wide_up_to_down,
/area/template_noop)
"ef" = (
/obj/structure/shuttle/part/dropship3/right_outer_wing_connector,
/turf/open/floor/plating/platingdmg3,
/area/template_noop)
"em" = (
/turf/closed/shuttle/dropship3/transparent{
	icon_state = "23"
	},
/area/template_noop)
"eu" = (
/obj/effect/decal/warning_stripes{
	icon_state = "cargo"
	},
/obj/effect/decal/hybrisa/dirt,
/obj/structure/surface/rack{
	color = "#848484"
	},
/obj/item/storage/pouch/survival/full/black,
/turf/open/shuttle/dropship/light_grey_single_wide_up_to_down,
/area/template_noop)
"eB" = (
/obj/structure/shuttle/part/dropship3/transparent/upper_left_wing,
/turf/open/floor/plating/platingdmg3,
/area/template_noop)
"fi" = (
/obj/structure/stairs{
	dir = 1
	},
/obj/structure/platform/metal/almayer/east,
/obj/structure/platform/metal/almayer/west,
/obj/effect/decal/hybrisa/dirt,
/turf/open/shuttle/dropship/light_grey_single_wide_up_to_down,
/area/template_noop)
"fu" = (
/obj/effect/decal/hybrisa/dirt,
/obj/item/tool/pen/blue{
	pixel_x = 5;
	pixel_y = 4
	},
/turf/open/shuttle/dropship/medium_grey_single_wide_up_to_down,
/area/template_noop)
"fL" = (
/turf/closed/shuttle/dropship3{
	icon_state = "83"
	},
/area/template_noop)
"hw" = (
/turf/template_noop,
/area/template_noop)
"hC" = (
/turf/closed/shuttle/dropship3{
	icon_state = "67"
	},
/area/template_noop)
"hD" = (
/obj/effect/decal/warning_stripes{
	icon_state = "cargo_arrow4";
	pixel_y = 15
	},
/obj/item/ammo_magazine/pistol/vp78/penetrating,
/turf/open/shuttle/dropship/light_grey_single_wide_up_to_down,
/area/template_noop)
"hO" = (
/obj/effect/decal/hybrisa/dirt,
/obj/item/stack/rods,
/obj/effect/landmark/corpsespawner/hybrisa/civilian,
/turf/open/shuttle/dropship/medium_grey_single_wide_up_to_down,
/area/template_noop)
"if" = (
/obj/structure/platform/metal/almayer/north,
/obj/effect/decal/hybrisa/dirt,
/turf/open/shuttle/dropship/light_grey_single_wide_up_to_down,
/area/template_noop)
"ik" = (
/obj/structure/largecrate/supply/floodlights,
/obj/effect/decal/warning_stripes{
	icon_state = "cargo"
	},
/turf/open/shuttle/dropship/light_grey_single_wide_up_to_down,
/area/template_noop)
"jy" = (
/turf/closed/shuttle/dropship3{
	icon_state = "14"
	},
/area/template_noop)
"jQ" = (
/turf/closed/shuttle/dropship3{
	icon_state = "81"
	},
/area/template_noop)
"kb" = (
/turf/closed/shuttle/dropship3{
	icon_state = "50"
	},
/area/template_noop)
"kr" = (
/obj/structure/bed/chair/dropship/passenger{
	dir = 8
	},
/obj/effect/decal/hybrisa/dirt,
/turf/open/shuttle/dropship/medium_grey_single_wide_up_to_down,
/area/template_noop)
"kO" = (
/turf/closed/shuttle/dropship3/transparent{
	icon_state = "22"
	},
/area/template_noop)
"kQ" = (
/obj/structure/bed/chair/dropship/passenger{
	dir = 1
	},
/obj/effect/decal/hybrisa/dirt,
/turf/open/shuttle/dropship/medium_grey_single_wide_up_to_down,
/area/template_noop)
"kS" = (
/obj/structure/shuttle/part/dropship3/left_inner_wing_connector,
/turf/open/floor/plating/platingdmg3,
/area/template_noop)
"lf" = (
/obj/structure/shuttle/part/dropship3/transparent/lower_left_wing,
/obj/effect/attach_point/weapon/dropship3/left_wing,
/turf/template_noop,
/area/template_noop)
"lk" = (
/turf/closed/shuttle/dropship3/transparent{
	icon_state = "29"
	},
/area/template_noop)
"lp" = (
/obj/effect/decal/hybrisa/dirt,
/turf/open/shuttle/dropship/light_grey_top_left,
/area/template_noop)
"lK" = (
/obj/effect/decal/cleanable/dirt/alt_dirt/stain,
/obj/effect/decal/remains/robot{
	pixel_x = 1;
	pixel_y = -1
	},
/turf/open/floor/plating/platingdmg3,
/area/template_noop)
"lQ" = (
/obj/effect/decal{
	icon = 'icons/mob/xenos/effects.dmi';
	icon_state = "acid_weak";
	name = "weak acid";
	layer = 12
	},
/turf/closed/shuttle/dropship3/transparent{
	icon_state = "32"
	},
/area/template_noop)
"lW" = (
/obj/effect/decal/warning_stripes{
	icon_state = "cargo"
	},
/obj/structure/largecrate/empty/case/double,
/turf/open/shuttle/dropship/light_grey_single_wide_up_to_down,
/area/template_noop)
"ms" = (
/obj/structure/bed/chair/vehicle{
	dir = 1;
	pixel_x = -8
	},
/obj/structure/bed/chair/vehicle{
	dir = 1;
	pixel_x = 8
	},
/turf/open/shuttle/dropship/medium_grey_single_wide_up_to_down,
/area/template_noop)
"mt" = (
/obj/structure/shuttle/part/dropship3/transparent/outer_left_weapons,
/turf/template_noop,
/area/template_noop)
"mA" = (
/obj/structure/bed/chair/dropship/passenger{
	dir = 8
	},
/turf/open/shuttle/dropship/medium_grey_single_wide_up_to_down,
/area/template_noop)
"mF" = (
/turf/closed/shuttle/dropship3/transparent{
	icon_state = "26"
	},
/area/template_noop)
"mJ" = (
/turf/open/shuttle/dropship/light_grey_single_wide_up_to_down,
/area/template_noop)
"nb" = (
/obj/effect/decal/hybrisa/dirt,
/obj/effect/decal/hybrisa/dirt,
/obj/effect/decal/hybrisa/dirt,
/turf/open/shuttle/dropship/light_grey_single_wide_up_to_down,
/area/template_noop)
"ng" = (
/obj/structure/shuttle/part/dropship3/transparent/right_inner_bottom_wing,
/turf/open/floor/plating/platingdmg3,
/area/template_noop)
"of" = (
/obj/item/stack/rods,
/obj/item/clothing/ears/earmuffs{
	pixel_y = 5;
	pixel_x = 3
	},
/turf/open/shuttle/dropship/light_grey_single_wide_up_to_down,
/area/template_noop)
"oL" = (
/turf/closed/shuttle/dropship3/transparent{
	icon_state = "97"
	},
/area/template_noop)
"pb" = (
/obj/structure/shuttle/part/dropship3/right_inner_wing_connector,
/turf/open/floor/plating/platingdmg3,
/area/template_noop)
"pn" = (
/obj/structure/shuttle/part/dropship3/transparent/outer_right_weapons,
/turf/template_noop,
/area/template_noop)
"qB" = (
/turf/closed/shuttle/dropship3/transparent{
	icon_state = "89"
	},
/area/template_noop)
"qR" = (
/obj/structure/bed/chair/vehicle{
	dir = 1;
	pixel_x = -8
	},
/obj/structure/bed/chair/vehicle{
	dir = 1;
	pixel_x = 8
	},
/obj/effect/landmark/corpsespawner/hybrisa/civilian,
/turf/open/shuttle/dropship/medium_grey_single_wide_up_to_down,
/area/template_noop)
"rk" = (
/obj/structure/bed/chair/vehicle{
	pixel_x = -8
	},
/obj/structure/bed/chair/vehicle{
	pixel_x = 8
	},
/obj/effect/decal/hybrisa/dirt,
/obj/effect/landmark/corpsespawner/hybrisa/civilian,
/obj/effect/spawner/gibspawner,
/turf/open/shuttle/dropship/medium_grey_single_wide_up_to_down,
/area/template_noop)
"rD" = (
/obj/structure/shuttle/part/dropship3/nose_front_right,
/turf/open/floor/plating/platingdmg3,
/area/template_noop)
"ss" = (
/obj/structure/shuttle/part/dropship3/transparent/engine_left_exhaust,
/turf/template_noop,
/area/template_noop)
"sC" = (
/obj/item/stack/cable_coil,
/turf/open/floor/plating/platingdmg3,
/area/template_noop)
"sR" = (
/obj/structure/bed/chair/vehicle{
	dir = 1;
	pixel_x = 8
	},
/obj/effect/decal/cleanable/blood,
/obj/effect/landmark/corpsespawner/hybrisa/civilian,
/turf/open/shuttle/dropship/medium_grey_single_wide_up_to_down,
/area/template_noop)
"sX" = (
/turf/closed/shuttle/dropship3/transparent{
	icon_state = "28"
	},
/area/template_noop)
"tq" = (
/obj/structure/prop/invuln/fire,
/turf/closed/shuttle/dropship3{
	icon_state = "51"
	},
/area/template_noop)
"tA" = (
/turf/closed/shuttle/dropship3{
	icon_state = "30"
	},
/area/template_noop)
"tQ" = (
/obj/effect/decal/warning_stripes{
	icon_state = "cargo"
	},
/obj/effect/decal/hybrisa/dirt,
/obj/structure/surface/rack{
	color = "#848484"
	},
/turf/open/shuttle/dropship/light_grey_single_wide_up_to_down,
/area/template_noop)
"tS" = (
/turf/closed/shuttle/dropship3{
	icon_state = "77"
	},
/area/template_noop)
"tT" = (
/obj/structure/girder/displaced,
/turf/open/floor/plating/platingdmg3,
/area/template_noop)
"uw" = (
/obj/structure/shuttle/part/dropship3/transparent/engine_right_exhaust,
/turf/open/floor/plating/platingdmg3,
/area/template_noop)
"uH" = (
/obj/structure/shuttle/part/dropship3/transparent/left_outer_bottom_wing,
/turf/open/floor/plating/platingdmg3,
/area/template_noop)
"uT" = (
/obj/structure/shuttle/part/dropship3/bottom_right_wall,
/turf/open/floor/plating/platingdmg3,
/area/template_noop)
"vn" = (
/turf/closed/shuttle/dropship3{
	icon_state = "18"
	},
/area/template_noop)
"vF" = (
/obj/effect/decal/hybrisa/dirt,
/obj/item/stack/sheet/wood{
	layer = 2.7
	},
/turf/open/shuttle/dropship/light_grey_single_wide_up_to_down,
/area/template_noop)
"vM" = (
/obj/structure/stairs{
	dir = 1
	},
/obj/structure/platform/metal/almayer/west,
/obj/structure/platform/metal/almayer/east,
/obj/effect/decal/hybrisa/dirt,
/obj/effect/decal/hybrisa/dirt,
/turf/open/shuttle/dropship/light_grey_single_wide_up_to_down,
/area/template_noop)
"vN" = (
/obj/item/stack/rods,
/turf/template_noop,
/area/template_noop)
"wy" = (
/obj/structure/machinery/door/airlock/multi_tile/almayer/dropshiprear/dropshipside/ds3{
	dir = 2;
	id = "port_door"
	},
/turf/open/shuttle/dropship/medium_grey_single_wide_up_to_down,
/area/template_noop)
"wB" = (
/obj/effect/decal/hybrisa/dirt,
/obj/item/device/flashlight/flare/on{
	fuel_rate = 2.5
	},
/turf/open/shuttle/dropship/light_grey_single_wide_up_to_down,
/area/template_noop)
"wH" = (
/obj/structure/surface/table/reinforced/black,
/obj/structure/machinery/computer/communications/simple{
	pixel_x = -12
	},
/obj/structure/machinery/computer/communications/simple{
	pixel_x = 6
	},
/turf/open/shuttle/dropship/medium_grey_single_wide_up_to_down,
/area/template_noop)
"wL" = (
/obj/structure/bed/chair/vehicle{
	pixel_x = -8
	},
/obj/item/stack/rods,
/obj/effect/decal/cleanable/blood,
/obj/effect/spawner/gibspawner/human,
/turf/open/shuttle/dropship/medium_grey_single_wide_up_to_down,
/area/template_noop)
"wO" = (
/turf/closed/shuttle/dropship3/transparent{
	icon_state = "35"
	},
/area/template_noop)
"xc" = (
/obj/structure/machinery/cm_vending/sorted/medical/wall_med{
	pixel_x = 30
	},
/obj/structure/machinery/light/double{
	dir = 4;
	pixel_y = -5
	},
/obj/effect/decal/hybrisa/dirt,
/turf/open/shuttle/dropship/medium_grey_single_wide_up_to_down,
/area/template_noop)
"yi" = (
/turf/closed/shuttle/dropship3{
	icon_state = "25"
	},
/area/template_noop)
"yB" = (
/obj/item/stack/rods,
/obj/effect/decal/cleanable/blood,
/obj/effect/spawner/gibspawner/human,
/turf/open/shuttle/dropship/medium_grey_single_wide_up_to_down,
/area/template_noop)
"zq" = (
/obj/structure/bed/chair/dropship/pilot{
	dir = 1;
	pixel_x = 10;
	pixel_y = 10
	},
/obj/structure/machinery/computer/cameras{
	desc = "The flight controls for a UD6 Dropship. these controls look pretty banged up, and there's some blood covering the screen..";
	name = "\improper 'Cash Flow' flight controls";
	network = null;
	pixel_y = 27;
	pixel_x = 7
	},
/turf/open/shuttle/dropship/medium_grey_single_wide_up_to_down,
/area/template_noop)
"zA" = (
/obj/structure/shuttle/part/dropship3/transparent/engine_left_cap,
/turf/open/floor/plating/platingdmg3,
/area/template_noop)
"zR" = (
/obj/structure/shuttle/part/dropship3/transparent/nose_top_right,
/turf/open/floor/plating/platingdmg3,
/area/template_noop)
"zW" = (
/obj/structure/shuttle/part/dropship3/nose_front_left,
/turf/open/floor/plating/platingdmg3,
/area/template_noop)
"zY" = (
/obj/item/stack/sheet/metal,
/turf/open/shuttle/dropship/light_grey_single_wide_up_to_down,
/area/template_noop)
"Ak" = (
/obj/structure/prop/invuln/fire,
/turf/closed/shuttle/dropship3/transparent{
	icon_state = "32"
	},
/area/template_noop)
"AJ" = (
/obj/effect/decal/hybrisa/dirt,
/turf/open/shuttle/dropship/medium_grey_single_wide_up_to_down,
/area/template_noop)
"Bm" = (
/turf/closed/shuttle/dropship3/transparent{
	icon_state = "78"
	},
/area/template_noop)
"BE" = (
/obj/effect/decal/hybrisa/dirt,
/obj/effect/decal/hybrisa/dirt,
/turf/open/shuttle/dropship/light_grey_single_wide_up_to_down,
/area/template_noop)
"Ca" = (
/obj/structure/prop/invuln/fire,
/turf/closed/shuttle/dropship3{
	icon_state = "52"
	},
/area/template_noop)
"Cc" = (
/turf/closed/shuttle/dropship3{
	icon_state = "68"
	},
/area/template_noop)
"CW" = (
/turf/closed/shuttle/dropship3{
	icon_state = "62"
	},
/area/template_noop)
"Dl" = (
/obj/effect/decal{
	icon = 'icons/mob/xenos/effects.dmi';
	icon_state = "acid_weak";
	name = "weak acid";
	layer = 12
	},
/turf/closed/shuttle/dropship3/transparent{
	icon_state = "38"
	},
/area/template_noop)
"DS" = (
/obj/structure/bed/chair/dropship/pilot{
	dir = 1;
	pixel_x = 10
	},
/obj/structure/machinery/computer/cameras{
	desc = "The flight controls for a UD6 Dropship. these controls look pretty banged up, and there's some blood covering the screen..";
	name = "\improper 'Cash Flow' flight controls";
	network = null;
	pixel_y = 14;
	pixel_x = 10
	},
/turf/open/shuttle/dropship/medium_grey_single_wide_up_to_down,
/area/template_noop)
"Ed" = (
/obj/structure/shuttle/part/dropship3/bottom_left_wall,
/turf/open/floor/plating/platingdmg3,
/area/template_noop)
"Et" = (
/obj/structure/shuttle/part/dropship3/transparent/engine_left_exhaust,
/obj/structure/prop/invuln/fire,
/turf/open/floor/plating/platingdmg3,
/area/template_noop)
"EF" = (
/turf/closed/shuttle/dropship3{
	icon_state = "92"
	},
/area/template_noop)
"EL" = (
/obj/structure/bed/chair/dropship/passenger{
	dir = 4
	},
/turf/open/shuttle/dropship/medium_grey_single_wide_up_to_down,
/area/template_noop)
"EQ" = (
/obj/structure/closet/crate/ammo/alt,
/obj/effect/decal/warning_stripes{
	icon_state = "cargo"
	},
/obj/item/explosive/plastic,
/obj/item/weapon/gun/flamer/m240{
	current_mag = null;
	layer = 3.1;
	pixel_y = 4
	},
/obj/item/ammo_magazine/flamer_tank,
/turf/open/shuttle/dropship/light_grey_single_wide_up_to_down,
/area/template_noop)
"EY" = (
/obj/structure/prop/invuln/fire,
/turf/closed/shuttle/dropship3/transparent{
	icon_state = "33"
	},
/area/template_noop)
"FF" = (
/obj/structure/shuttle/part/dropship3/transparent/middle_left_wing,
/obj/structure/machinery/light/dropship/red{
	dir = 8
	},
/turf/template_noop,
/area/template_noop)
"FP" = (
/turf/closed/shuttle/dropship3{
	icon_state = "69"
	},
/area/template_noop)
"Gc" = (
/obj/structure/shuttle/part/dropship3/transparent/left_outer_inner_wing,
/turf/open/floor/plating/platingdmg3,
/area/template_noop)
"Gk" = (
/turf/closed/shuttle/dropship3{
	icon_state = "73"
	},
/area/template_noop)
"Gt" = (
/obj/structure/bed/chair/vehicle{
	pixel_x = -8
	},
/obj/structure/bed/chair/vehicle{
	pixel_x = 8
	},
/turf/open/shuttle/dropship/medium_grey_single_wide_up_to_down,
/area/template_noop)
"Gx" = (
/obj/structure/platform_decoration/metal/almayer/east,
/obj/structure/platform_decoration/metal/almayer/west,
/obj/effect/decal/warning_stripes{
	icon_state = "cargo_arrow4";
	dir = 1;
	pixel_y = -18
	},
/obj/effect/decal/hybrisa/dirt,
/obj/effect/decal/hybrisa/dirt,
/obj/item/ammo_magazine/pistol/vp78/penetrating,
/turf/open/shuttle/dropship/light_grey_single_wide_up_to_down,
/area/template_noop)
"GZ" = (
/obj/effect/decal/warning_stripes{
	icon_state = "cargo"
	},
/obj/effect/decal/hybrisa/dirt,
/obj/structure/surface/rack{
	color = "#848484"
	},
/obj/structure/largecrate/random/mini/ammo{
	pixel_y = 8;
	pixel_x = -1
	},
/turf/open/shuttle/dropship/light_grey_single_wide_up_to_down,
/area/template_noop)
"Hl" = (
/obj/structure/shuttle/part/dropship3/transparent/engine_left_cap,
/obj/effect/decal/cleanable/dirt/alt_dirt/stain,
/obj/effect/decal/remains/robot{
	pixel_x = 1;
	pixel_y = -1
	},
/turf/open/floor/plating/platingdmg3,
/area/template_noop)
"HC" = (
/obj/structure/shuttle/part/dropship3/transparent/nose_top_left,
/turf/open/floor/plating/platingdmg3,
/area/template_noop)
"HW" = (
/obj/structure/bed/chair/vehicle{
	pixel_x = -8
	},
/obj/structure/bed/chair/vehicle{
	pixel_x = 8
	},
/obj/effect/landmark/ert_spawns/distress_twe,
/turf/open/shuttle/dropship/medium_grey_single_wide_up_to_down,
/area/template_noop)
"IH" = (
/obj/structure/shuttle/part/dropship3/transparent/right_outer_bottom_wing,
/turf/open/floor/plating/platingdmg3,
/area/template_noop)
"II" = (
/obj/item/stack/rods,
/obj/effect/decal/cleanable/blood,
/turf/open/floor/plating/platingdmg3,
/area/template_noop)
"IV" = (
/obj/effect/spawner/gibspawner/human,
/turf/open/floor/plating/platingdmg3,
/area/template_noop)
"Jr" = (
/obj/structure/bed/chair/dropship/passenger,
/turf/open/shuttle/dropship/medium_grey_single_wide_up_to_down,
/area/template_noop)
"JS" = (
/obj/effect/decal/hybrisa/dirt,
/obj/item/device/flashlight/flare/on{
	fuel_rate = 2.5
	},
/turf/open/shuttle/dropship/light_grey_top_right,
/area/template_noop)
"JX" = (
/turf/closed/shuttle/dropship3{
	icon_state = "94"
	},
/area/template_noop)
"Ks" = (
/obj/structure/shuttle/part/dropship3/transparent/nose_center,
/turf/open/floor/plating/platingdmg3,
/area/template_noop)
"KM" = (
/obj/structure/bed/chair/vehicle{
	dir = 1;
	pixel_x = -8
	},
/obj/structure/bed/chair/vehicle{
	dir = 1;
	pixel_x = 8
	},
/obj/effect/decal/cleanable/blood,
/obj/effect/landmark/corpsespawner/hybrisa/civilian,
/turf/open/shuttle/dropship/medium_grey_single_wide_up_to_down,
/area/template_noop)
"KX" = (
/obj/structure/machinery/cm_vending/sorted/medical/wall_med{
	pixel_x = -30
	},
/obj/structure/machinery/light/double{
	dir = 8;
	pixel_y = -5
	},
/obj/effect/decal/hybrisa/dirt,
/turf/open/shuttle/dropship/medium_grey_single_wide_up_to_down,
/area/template_noop)
"Ll" = (
/obj/item/device/flashlight/flare/on{
	fuel_rate = 2.5
	},
/obj/item/clothing/ears/earmuffs{
	pixel_y = 5;
	pixel_x = 3
	},
/turf/open/shuttle/dropship/light_grey_single_wide_up_to_down,
/area/template_noop)
"Lm" = (
/obj/item/stack/rods,
/obj/item/ammo_magazine/pistol/vp78/penetrating,
/turf/open/floor/plating/platingdmg3,
/area/template_noop)
"Ln" = (
/turf/closed/shuttle/dropship3{
	icon_state = "10"
	},
/area/template_noop)
"LG" = (
/obj/item/stack/sheet/metal,
/obj/effect/landmark/corpsespawner/hybrisa/civilian,
/turf/open/floor/plating/platingdmg3,
/area/template_noop)
"LR" = (
/turf/closed/shuttle/dropship3{
	icon_state = "53"
	},
/area/template_noop)
"Mj" = (
/obj/structure/surface/table/reinforced/black,
/obj/item/tool/pen/blue{
	pixel_x = 5;
	pixel_y = 4
	},
/turf/open/shuttle/dropship/medium_grey_single_wide_up_to_down,
/area/template_noop)
"Mr" = (
/obj/effect/decal/hybrisa/dirt,
/turf/open/shuttle/dropship/light_grey_single_wide_up_to_down,
/area/template_noop)
"ME" = (
/obj/structure/bed/chair/vehicle{
	dir = 1;
	pixel_x = -8
	},
/obj/structure/bed/chair/vehicle{
	dir = 1;
	pixel_x = 8
	},
/obj/effect/decal/hybrisa/dirt,
/turf/open/shuttle/dropship/medium_grey_single_wide_up_to_down,
/area/template_noop)
"Nn" = (
/obj/effect/decal/hybrisa/dirt,
/obj/effect/landmark/ert_spawns/distress_twe,
/turf/open/shuttle/dropship/medium_grey_single_wide_up_to_down,
/area/template_noop)
"NC" = (
/obj/structure/bed/chair/vehicle{
	pixel_x = -8
	},
/obj/structure/bed/chair/vehicle{
	pixel_x = 8
	},
/obj/effect/decal/hybrisa/dirt,
/turf/open/shuttle/dropship/medium_grey_single_wide_up_to_down,
/area/template_noop)
"Op" = (
/obj/effect/decal/hybrisa/dirt,
/obj/item/stack/rods,
/turf/open/shuttle/dropship/medium_grey_single_wide_up_to_down,
/area/template_noop)
"Pl" = (
/turf/closed/shuttle/dropship3{
	icon_state = "75"
	},
/area/template_noop)
"PO" = (
/obj/structure/shuttle/part/dropship3/transparent/engine_left_exhaust,
/turf/open/floor/plating/platingdmg3,
/area/template_noop)
"Qq" = (
/obj/effect/decal/hybrisa/dirt,
/obj/item/stack/rods,
/turf/open/shuttle/dropship/light_grey_single_wide_up_to_down,
/area/template_noop)
"Qy" = (
/obj/structure/platform_decoration/metal/almayer/west,
/obj/structure/platform_decoration/metal/almayer/east,
/obj/effect/decal/warning_stripes{
	icon_state = "cargo_arrow4";
	dir = 1;
	pixel_y = -18
	},
/obj/effect/decal/hybrisa/dirt,
/obj/effect/decal/hybrisa/dirt,
/turf/open/shuttle/dropship/light_grey_single_wide_up_to_down,
/area/template_noop)
"QO" = (
/obj/effect/attach_point/crew_weapon/dropship3/floor{
	attach_id = 7
	},
/obj/effect/decal/cleanable/dirt/alt_dirt/stain,
/turf/open/shuttle/dropship/medium_grey_single_wide_left_to_right,
/area/template_noop)
"QZ" = (
/obj/item/stack/sheet/metal,
/turf/open/floor/plating/platingdmg3,
/area/template_noop)
"Rh" = (
/obj/structure/machinery/door/airlock/multi_tile/almayer/dropshiprear/ds3{
	id = "aft_door"
	},
/turf/open/shuttle/dropship/medium_grey_single_wide_up_to_down,
/area/template_noop)
"Rn" = (
/turf/closed/shuttle/dropship3/transparent{
	icon_state = "33"
	},
/area/template_noop)
"Rt" = (
/obj/item/stack/rods,
/obj/item/stack/sheet/metal,
/turf/open/floor/plating/platingdmg3,
/area/template_noop)
"Sy" = (
/turf/closed/shuttle/dropship3{
	icon_state = "24"
	},
/area/template_noop)
"SD" = (
/turf/closed/shuttle/dropship3{
	icon_state = "31"
	},
/area/template_noop)
"UR" = (
/turf/closed/shuttle/dropship3{
	icon_state = "59"
	},
/area/template_noop)
"Vd" = (
/obj/structure/platform/metal/almayer/north,
/obj/structure/machinery/light/double{
	dir = 8;
	pixel_y = -5
	},
/turf/open/shuttle/dropship/light_grey_single_wide_up_to_down,
/area/template_noop)
"VE" = (
/obj/structure/shuttle/part/dropship3/left_outer_wing_connector,
/turf/open/floor/plating/platingdmg3,
/area/template_noop)
"VF" = (
/obj/structure/surface/table/reinforced/black,
/obj/item/ammo_box/magazine/l42a,
/turf/open/shuttle/dropship/medium_grey_single_wide_up_to_down,
/area/template_noop)
"Wb" = (
/turf/closed/shuttle/dropship3/transparent{
	icon_state = "27"
	},
/area/template_noop)
"Wr" = (
/turf/closed/shuttle/dropship3{
	icon_state = "72"
	},
/area/template_noop)
"Ww" = (
/turf/closed/shuttle/dropship3{
	icon_state = "52"
	},
/area/template_noop)
"WV" = (
/obj/effect/decal/warning_stripes{
	icon_state = "cargo_arrow4";
	pixel_y = 15
	},
/turf/open/shuttle/dropship/light_grey_single_wide_up_to_down,
/area/template_noop)
"WZ" = (
/obj/effect/decal/hybrisa/dirt,
/obj/effect/landmark/ert_spawns/distress_twe,
/turf/open/shuttle/dropship/light_grey_single_wide_up_to_down,
/area/template_noop)
"Xd" = (
/obj/structure/prop/invuln/fire,
/turf/closed/shuttle/dropship3/transparent{
	icon_state = "39"
	},
/area/template_noop)
"Yb" = (
/obj/effect/attach_point/crew_weapon/dropship3/floor{
	attach_id = 7
	},
/turf/open/shuttle/dropship/medium_grey_single_wide_up_to_down,
/area/template_noop)
"Yf" = (
/turf/open/shuttle/dropship/light_grey_top_left,
/area/template_noop)
"Yp" = (
/turf/open/floor/plating/platingdmg3,
/area/template_noop)
"Yq" = (
/turf/closed/shuttle/dropship3/transparent{
	icon_state = "34"
	},
/area/template_noop)
"Zn" = (
/obj/item/stack/rods,
/turf/open/floor/plating/platingdmg3,
/area/template_noop)
"ZN" = (
/obj/structure/machinery/door/airlock/multi_tile/almayer/dropshiprear/dropshipside/ds3{
	dir = 1;
	id = "starboard_door"
	},
/turf/open/shuttle/dropship/medium_grey_single_wide_up_to_down,
/area/template_noop)

(1,1,1) = {"
hw
hw
hw
hw
hw
hw
hw
hw
hw
hw
hw
hw
hw
hw
hw
hw
hw
hw
hw
hw
hw
hw
hw
hw
hw
hw
hw
hw
hw
hw
hw
hw
"}
(2,1,1) = {"
hw
hw
hw
hw
hw
hw
hw
hw
hw
hw
hw
hw
hw
hw
hw
hw
hw
hw
hw
hw
hw
hw
hw
hw
hw
hw
hw
hw
hw
hw
hw
hw
"}
(3,1,1) = {"
hw
hw
hw
hw
hw
hw
hw
hw
hw
hw
hw
hw
hw
hw
hw
hw
hw
hw
hw
hw
hw
hw
hw
hw
hw
hw
hw
hw
hw
hw
hw
hw
"}
(4,1,1) = {"
hw
hw
hw
hw
hw
hw
hw
hw
hw
hw
hw
hw
hw
hw
hw
hw
hw
hw
hw
hw
hw
hw
hw
hw
hw
hw
hw
hw
hw
hw
hw
hw
"}
(5,1,1) = {"
hw
hw
hw
hw
hw
hw
hw
hw
hw
hw
hw
hw
hw
hw
hw
hw
hw
hw
hw
hw
Yp
hw
hw
hw
hw
hw
hw
hw
hw
hw
hw
hw
"}
(6,1,1) = {"
hw
hw
hw
hw
hw
hw
hw
hw
hw
hw
hw
hw
hw
hw
hw
hw
hw
Yp
hw
Yp
Yp
hw
hw
hw
hw
hw
hw
hw
hw
hw
hw
hw
"}
(7,1,1) = {"
hw
hw
hw
hw
hw
hw
hw
hw
Yp
hw
hw
hw
hw
hw
hw
hw
tT
hw
hw
Yp
Yp
hw
hw
zA
Yq
sX
kO
ss
Yp
hw
Yp
hw
"}
(8,1,1) = {"
hw
hw
hw
hw
hw
hw
vN
hw
hw
Yp
Yp
hw
hw
hw
lK
LG
Zn
hw
Yp
Yp
hw
Yp
Yp
cU
wO
lk
em
uw
Yp
Yp
uH
hw
"}
(9,1,1) = {"
hw
hw
hw
hw
vN
Zn
eB
FF
FF
lf
mt
Pl
Ca
tT
IV
Lm
sC
Yp
dj
wy
Ww
Ww
Ww
Ww
Ww
tA
Sy
vn
Ed
Yp
Gc
Yp
"}
(10,1,1) = {"
hw
hw
Yp
Yp
Yp
tT
Wr
hC
hC
CW
kb
tS
Gt
sR
Op
AJ
wL
qR
dj
Nn
KX
rk
ms
EL
Vd
EQ
ik
mJ
Ln
kS
VE
Yp
"}
(11,1,1) = {"
hw
HC
zW
EF
tT
tT
wH
kQ
fu
Jr
VF
Bm
lp
BE
zY
Ll
mJ
mJ
Qq
mJ
WZ
BE
nb
vM
Qy
Mr
wB
hD
Rh
Yp
Yp
hw
"}
(12,1,1) = {"
hw
Ks
oL
zq
DS
dj
mJ
Mr
Mr
WZ
mJ
Yf
dz
AJ
ms
HW
dj
dj
QO
ms
Cc
UR
LR
Yb
if
GZ
tQ
mJ
dj
Yp
Yp
hw
"}
(13,1,1) = {"
hw
zR
rD
JX
qB
tT
Mj
kQ
bT
kr
mA
Bm
JS
BE
WZ
Mr
mJ
mJ
mJ
al
of
Mr
vF
fi
Gx
Qq
WZ
WV
dj
Yp
Yp
Yp
"}
(14,1,1) = {"
hw
hw
Yp
Yp
Yp
Rt
Gk
FP
FP
tT
Yp
jQ
Gt
ME
NC
KM
dZ
ms
dj
AJ
xc
AJ
yB
hO
bw
eu
lW
mJ
jy
pb
ef
Yp
"}
(15,1,1) = {"
hw
hw
Yp
hw
Zn
Yp
QZ
Yp
Yp
Yp
pn
fL
tq
bu
SD
yi
bu
bu
dj
ZN
bu
tT
Yp
II
bu
SD
yi
bu
uT
Yp
ng
Yp
"}
(16,1,1) = {"
hw
hw
hw
Yp
QZ
hw
vN
hw
Yp
hw
vN
Yp
zA
Dl
Ak
mF
PO
Yp
Yp
Yp
hw
hw
Rt
Hl
dH
lQ
mF
Et
Yp
Yp
IH
Yp
"}
(17,1,1) = {"
hw
hw
hw
hw
hw
Yp
hw
hw
vN
hw
hw
hw
cU
Xd
Rn
aD
uw
Yp
hw
hw
hw
hw
hw
cU
Xd
EY
Wb
uw
Yp
Yp
Yp
Yp
"}
(18,1,1) = {"
hw
hw
hw
hw
hw
hw
hw
hw
hw
hw
hw
hw
hw
Yp
Yp
Yp
Yp
Yp
hw
hw
Yp
hw
hw
hw
Yp
Zn
tT
Yp
Yp
Yp
hw
hw
"}
(19,1,1) = {"
hw
hw
hw
hw
hw
hw
hw
hw
hw
hw
hw
hw
hw
hw
hw
hw
hw
hw
hw
hw
hw
Yp
hw
hw
hw
hw
hw
hw
hw
hw
hw
hw
"}
(20,1,1) = {"
hw
hw
hw
hw
hw
hw
hw
hw
hw
hw
hw
hw
hw
hw
hw
hw
hw
hw
hw
hw
hw
hw
hw
hw
hw
hw
hw
hw
hw
hw
hw
hw
"}
(21,1,1) = {"
hw
hw
hw
hw
hw
hw
hw
hw
hw
hw
hw
hw
hw
hw
hw
hw
hw
hw
hw
hw
hw
hw
hw
hw
hw
hw
hw
hw
hw
hw
hw
hw
"}
(22,1,1) = {"
hw
hw
hw
hw
hw
hw
hw
hw
hw
hw
hw
hw
hw
hw
hw
hw
hw
hw
hw
hw
hw
hw
hw
hw
hw
hw
hw
hw
hw
hw
hw
hw
"}
(23,1,1) = {"
hw
hw
hw
hw
hw
hw
hw
hw
hw
hw
hw
hw
hw
hw
hw
hw
hw
hw
hw
hw
hw
hw
hw
hw
hw
hw
hw
hw
hw
hw
hw
hw
"}
(24,1,1) = {"
hw
hw
hw
hw
hw
hw
hw
hw
hw
hw
hw
hw
hw
hw
hw
hw
hw
hw
hw
hw
hw
hw
hw
hw
hw
hw
hw
hw
hw
hw
hw
hw
"}
